###############
# # B         #
# ### ### # ###
#  L  #   #  L#
# ### # #######
###   #   A   #
# # # # ### ###
# # # # #     #
# # #   ### ###
# L # #   #   #
# ### ### ### E
# # A #     # #
# # # # ### # #
# P #   A     #
###############

3 3 11 4
9 2 5 10
3 13 13 8
