#####B#########
#  L#     #   #
# ### ### # ###
#     #   #   #
# ### ##### ###
# #   # #     #
### ### ### ###
# # #         #
# # # ##### ###
# A # #       E
# ### ####### #
# #   #     # #
# # # # ### # #
# LA#   #     #
##P############
