###############
# #  B        #
# ### ### # ###
#  L  #   #  L#
# ### # #######
###   #   A   #
# # # # # # ###
# # # ###     #
# # #   ### ###
# L # #   #   #
# ### ####### E
# # A #     #A#
# # # # ### # #
# P #   #     #
###############

3 3 11 4
9 2 5 10
3 13 11 13
