##### #########
#   #     #   #
# ### ### # ###
#     #   #   #
# ### ##### ###
# #   # #     #
### ### ### ###
# # #         #
# # # ##### ###
#   # #        
# ### ####### #
# #   #     # #
# # # # ### # #
#   #   #     #
###############
